11111111111           11111
  111111              11111  
   111111111111111111111111
   11000N00011111 11111111111  1
   111111110111111111111111
   1111111111111111111111111
