11111111111           11111
  110000              10001  
   100001111111111111110011
   10N000000000 00000000001  0
   111111111111111111111111