   WE                            ./textures/wolfenstein/eagle.xpm 
NO      ./textures/wolfenstein/grey_stone.xpm



SO ./textures/wolfenstein/red_brick.xpm

F   69, 100, 199

EA ./textures/wolfenstein/mossy.xpm



C 30, 198, 52

111111111111111111111111
100000000000000000000001
100000000000000000000001
100000000N00000000000001
100000000000000000000001
100000000000000000000001
100000000000000000000001
100000111110000101010001
100000100010000000000001
100000100010000100010001
100000100010000000000001
100000111100001010100001
100000000000000000000001
100000000000000000000001
100000000000000000000001
100000000000000000000001
100000000000000000000001
100000000000000000000001
100000000000000000000001
111111111000000000000001
100100001000000000000001
100000101000000000000001
100100001000000000000001
100111111000000000000001
100000000000000000000001
100000000000000000000001
111111111111111111111111
