NO ./textures/no_test.xpm 
EA ./textures/ea_test.xpm                
SO ./textures/so_test.xpm
WE ./textures/we_test.xpm   

F 226,111,1 
C 200,31,00
   



11111111111           11111
  111111              11111  
   11111111111 111 11111111
   11000N00000 111 11111111111  1
11111111111111111111111111111111111
1111
1111111111111111111111111111111111111
   111111110111111111111111
   111111111111111111111111